NO maps/NO.xpm
SO maps/SO.xpm
WE maps/WE.xpm
EA maps/EA.xpm


F 220,100,4
C 225,30,4

1111111111111111111
1000000000000000001
1000000000000000001
10000000S0000000001
1000000000000000001
1000000010000000001
1000000001000000001
1000000000000000001
1000000000000000001
1001001001001001001
1001001001001001001
1001001001001001001
1001001000001001001
1000000000000000001
1000011111111000001
1111000000000001111
1000000101010000001
1111111111111111111